1111111111111111111111111111111111
1P1C1C00000C100C100C100C100C1000C1
1C10101011100C100C100C100C100C1001
101010101C111011111110111111111111
1C100C1C100C00C00C00C00C00C01C0C01
10C01C1C000C0010C1C1010C0100C0C1E1
1111111111111111111111111111111111
