1111111111111111111111111111111111
1P1C1C00000C100C100C000C100C1000C1
1C10101011100C100C100C100C100C1001
101010101C111011111110010011111111
1C000C1C100C00C00C00C00C10C00C0CE1
1111111111111111111111111111111111